~~~~=#``#`
~~~`=##`#`
~```==#`#`
+++``=====
==+```=```
=======```
==+```````
+++```````
``````````
``````````