++++=#``#`
~~~+=##`#`
++++==#`#`
+++``=====
==+```=```
=======```
==+```````
+++```````
``````````
``````````